R 720 480

EA pics/EA.xpm
WE pics/WE.xpm
NO pics/NO.xpm
SO pics/SO.xpm
S pics/ITEM.xpm

F 50,180,100
C 00,90,130

        1111111111111111111111111
        1000000000000000000000001
        1100000000000000000000001
        1000000000000000000000001
111111111000000000000000000000001
100000002220000000000000000001111
10000000220000E10000000000001
10000000000000000000000000001
10002002002000200020020020001
10000020002000200020020000001
10000000000000000001010000001
11000001110101011111011110101
11110111 1110121 101111010001
11111111 1111111 111111111111