R 720 480

EA pics/EA.xpm
WE pics/WE.xpm
NO pics/NO.xpm
SO pics/SO.xpm
S pics/ITEM.xpm

F 50,180,100
C 0,90,130

        1111111111111111111111111
        1000000000110000000000001
        101100000111020W002000001
        1001002000000002000000001
111111111011000001110000000000001
100000000011000001110111111111111
11110111111111011100000010001
11110111111111011101010010001
11000000110101011100000010001
10002000000000001100000010001
10000000000000001101010010001
1100000111010101111101111000111
11110111 1110101 101111010001
11111111 1111111 111111111111